107
8
38 0 0 0 0 0 0 0 0 0 0 0 0 0 0 0 0 0 0 0 18 19 20 21 22 0 0 0 0 0 0 0 0 0 0 0 0 0 0 0 23 24 25 26 27 0 0 0 0 0 0 0 0 0 0 0 0 0 0 0 0 0 0 0 0 0 0 0 0 0 50 50 50 0 0 0 0 0 0 0 0 0 0 0 0 0 0 33 33 33 33 33 33 33 33 33 33 33 33 33 0 0 0 0 0 0 0 
39 0 0 13 14 15 16 17 0 0 0 0 0 0 0 0 0 0 0 0 51 52 53 54 55 0 0 0 0 0 0 0 0 0 0 0 0 0 0 0 56 57 58 59 60 0 0 0 0 0 0 0 0 0 0 0 0 0 0 0 0 0 0 0 28 29 30 31 32 0 0 50 50 0 0 0 0 0 0 0 0 0 0 0 0 0 0 33 33 33 33 33 33 33 33 33 33 33 33 33 0 0 0 0 0 0 0 
39 0 0 8 9 10 11 12 0 0 0 0 0 0 0 0 0 0 0 0 0 0 0 0 0 0 0 0 0 0 0 0 0 0 0 0 0 0 0 0 0 0 0 0 0 0 0 0 0 0 0 0 0 0 0 0 0 0 0 0 0 0 0 0 61 62 63 64 65 0 0 0 0 0 0 0 0 0 0 0 0 0 0 0 0 0 0 33 33 33 33 33 33 33 33 33 33 33 33 33 0 0 0 0 0 0 0 
39 0 0 0 0 0 0 0 0 0 0 0 0 0 0 0 0 0 0 0 0 0 0 0 0 0 0 0 0 0 0 0 1 0 0 0 0 0 0 0 0 0 0 0 0 0 0 0 0 0 0 0 0 0 0 0 0 0 0 0 0 0 0 0 0 0 0 0 0 0 0 0 0 0 0 0 0 0 0 0 0 0 0 0 0 0 0 33 33 33 33 33 33 33 33 33 33 33 33 33 0 0 0 0 0 0 0 
39 0 0 0 0 0 0 0 0 0 0 0 0 0 0 0 0 0 0 0 0 0 0 0 0 0 0 0 0 0 0 0 44 43 0 0 0 0 0 0 0 0 0 0 4 0 0 0 0 0 0 0 3 0 0 0 1 0 0 0 0 0 0 0 0 0 0 0 0 0 0 0 0 0 0 0 1 0 4 0 1 0 0 0 0 0 0 37 33 33 33 33 33 33 33 33 33 33 33 33 0 0 0 0 0 0 0 
39 0 0 0 0 0 0 0 0 0 0 0 0 0 0 0 0 0 0 0 0 0 0 0 0 0 44 34 43 2 0 44 46 39 0 0 0 0 0 0 0 0 44 34 34 43 0 0 0 0 0 0 44 34 34 34 34 43 0 0 0 0 0 0 0 0 5 0 0 0 0 4 2 0 0 0 44 34 34 34 34 43 0 0 0 0 0 40 33 33 33 33 33 33 33 33 33 33 33 33 0 0 0 0 0 0 0 
39 0 1 0 0 0 4 1 0 0 2 0 0 0 4 0 0 1 0 0 0 2 0 3 44 34 46 33 45 34 34 46 33 39 0 2 0 0 0 1 0 0 40 33 33 39 0 2 0 0 1 0 40 33 33 33 33 45 43 1 0 4 0 2 0 3 44 43 0 0 35 34 34 36 0 0 41 33 33 33 33 39 0 5 0 7 3 40 33 33 33 33 33 33 33 33 33 33 33 33 0 0 0 0 0 0 0 
45 34 34 34 34 34 34 34 34 34 34 34 34 34 34 34 34 34 34 34 34 34 34 34 46 33 33 33 33 33 33 33 33 45 34 34 34 34 34 34 34 34 46 33 33 45 34 34 34 34 34 34 46 33 33 33 33 33 45 34 34 34 34 34 34 34 46 42 0 0 0 0 0 0 0 0 33 33 33 33 33 45 34 34 34 34 34 46 33 33 33 33 33 33 33 33 33 33 33 33 0 0 0 0 0 0 0 
